22 serialization::archive 14 1 0
0 0 0 4 map2 0 0 10 0 0 0 7 0 4 1 0
1 -1 0 0 4
2 -1 0 1 4
3 -1 0 2 4
4 -1 0 3 4
5 -1 0 4 4
6 -1 0 5 4
7 -1 0 6 7 0 4
8 -1 1 0 4
9 -1 1 1 4
10 -1 1 2 4
11 -1 1 3 4
12 -1 1 4 4
13 -1 1 5 4
14 -1 1 6 7 0 4
15 -1 2 0 4
16 -1 2 1 4
17 -1 2 2 4
18 -1 2 3 4
19 -1 2 4 4
20 -1 2 5 4
21 -1 2 6 7 0 4
22 -1 3 0 4
23 -1 3 1 4
24 -1 3 2 4
25 -1 3 3 4
26 -1 3 4 4
27 -1 3 5 4
28 -1 3 6 7 0 4
29 -1 4 0 4
30 -1 4 1 4
31 -1 4 2 4
32 -1 4 3 4
33 -1 4 4 4
34 -1 4 5 4
35 -1 4 6 7 0 4
36 -1 5 0 4
37 -1 5 1 4
38 -1 5 2 4
39 -1 5 3 4
40 -1 5 4 4
41 -1 5 5 4
42 -1 5 6 7 0 4
43 -1 6 0 4
44 -1 6 1 4
45 -1 6 2 4
46 -1 6 3 4
47 -1 6 4 4
48 -1 6 5 4
49 -1 6 6 7 0 4
50 -1 7 0 4
51 -1 7 1 4
52 -1 7 2 4
53 -1 7 3 4
54 -1 7 4 4
55 -1 7 5 4
56 -1 7 6 7 0 4
57 -1 8 0 4
58 -1 8 1 4
59 -1 8 2 4
60 -1 8 3 4
61 -1 8 4 4
62 -1 8 5 4
63 -1 8 6 7 0 4
64 -1 9 0 4
65 -1 9 1 4
66 -1 9 2 4
67 -1 9 3 4
68 -1 9 4 4
69 -1 9 5 4
70 -1 9 6 0 0 2 0 4 1 4 70
